NO ./assets/w2.xpm
SO ./assets/w2.xpm
WE ./assets/w2.xpm
EA ./assets/w2.xpm

F 220,100,0
C 225,30,0

        1111111111111111111111111
        1000000000110000000000001
        1011000001110000000000001
        1001000000000000000000001
111111111011000001110000000000001
100000000011000001110111111111111
11110111111111011100000010001
11110111111111011101010010001
11000000110101011100010010001
100000000000000011001N1010111
10000000000000001101010010111
110000011101010111110111100111
11110111 1110101 10111101001
11111111 1111111 111111111111
