NO ./assets/path_to_the_north_texture.xpm
SO ./assets/path_to_the_south_texture.xpm
WE ./assets/path_to_the_west_texture.xpm
EA ./assets/path_to_the_east_texture.xpm

F 20, 0 ,00
C 100,30    ,0

1111111111111111111111111                     11111
1000000000110000000000001                     10001
1011000001110000000000001                     11111
100100000000000000000000111111111
111111111011000001110000000000001
100000000011000001110111111111111
11110111111111011100000010001
11110111111111011101010010001
11000000110101011100000010001
1000000000000000110000001001
100000S0000000001101010010001
110000011101010111110111100011
11110111 1110101 10111101001
11111111 1111111 111111111111            1
