NO ./assets/w2.xpm
SO ./assets/w2.xpm
WE ./assets/w3.xpm
EA ./assets/w2.xpm

F 20,  ,00
C 100,30    ,0

1111111111111111111111111111111111111
1N00000000000000000000000000000000001
1000000000000000000000000000000000001
1000000000000000000000000000000000001
1000000000000000000000000000000000001
100000000000000000000000000000000001
 111111111111111111111111111111111111
