NO ./path_to_the_north_texture.xpm
SO ./path_to_the_south_texture.xpm
WE ./path_to_the_west_texture.xpm
EA ./path_to_the_east_texture.xpm

F 220,        100,            0
C 225,30    ,0

1111111111111111111111111                     11111
1000000000110000000000001                     10001
1011000001110000000000001                     11111
100100000000000000000000111111111
111111111011000001110000000000001
100000000011000001110111111111111
11110111111111011100000010001
11110111111111011101010010001
11000000110101011100000010001
10000000000000001100000010001
10000000000000001101010010001
1100000111010101111101111000111
11110111 1110101 10111101000
11111111 1111111 111111111111            1
                                        101
                                        101
1111111111111111111111111                1    11111
1000000000110000000000001                     10001
1011000001110000000000001                     11111
100100000000000000000000111111111
111111111011000001110000000000001
100000000011000001110111111111111
11110111111111011100000010001
11110111111111011101010010001
11000000110101011100000010001
10000000000000001100000010001
10000000000000001101010010001
110000S1110101011111S11100111
11110111 1110101 10111101000
11111111 1111111 111111111111
1111111111111
1111101111111
111             111111111
111             11000000011111
101             1000000000000111111
111             10000000000000000001111111111111111111111111
111             100000000000000000000000000000000000000000001
                10000000000000000111111111111111111111111111
                10000111111111111
                1001
                101
                 1
