NO ./assets/w2.xpm
SO ./assets/w2.xpm
WE ./assets/saincesu.xpm
EA ./assets/saincesu.xpm

F 20, 1 ,00
C 100,30    ,0

11111111
1N000001
10000001
10000001
10000001
1000001
 1111111
