NO ./assets/Player.xpm
SO ./assets/path_to_the_south_texture.xpm
WE ./assets/path_to_the_west_texture.xpm
EA ./assets/path_to_the_east_texture.xpm

F 221, 0 ,00
C 225,30    ,0

1111111111111111111111111111111111111
1E00000000000000000000000000000000001
1100000000000000000000000000000000001
1100000000000000000000000000000000001
1100000000000000000000000000000000001
1100000000000000000000000000000000001
1111111111111111111111111111111111111
